EURUSD=X - Euro US Dollar Exchange Rate
GBPUSD=X - British Pound US Dollar Exchange Rate
USDJPY=X - US Dollar Japanese Yen Exchange Rate
USDCHF=X - US Dollar Swiss Franc Exchange Rate
AUDUSD=X - Australian Dollar US Dollar Exchange Rate
USDCAD=X - US Dollar Canadian Dollar Exchange Rate
NZDUSD=X - New Zealand Dollar US Dollar Exchange Rate
EURGBP=X - Euro British Pound Exchange Rate
EURJPY=X - Euro Japanese Yen Exchange Rate
GBPJPY=X - British Pound Japanese Yen Exchange Rate
USDSEK=X - US Dollar Swedish Krona Exchange Rate
USDNOK=X - US Dollar Norwegian Krone Exchange Rate
EURCHF=X - Euro Swiss Franc Exchange Rate
AUDJPY=X - Australian Dollar Japanese Yen Exchange Rate
EURAUD=X - Euro Australian Dollar Exchange Rate
GBPAUD=X - British Pound Australian Dollar Exchange Rate
USDMXN=X - US Dollar Mexican Peso Exchange Rate
USDZAR=X - US Dollar South African Rand Exchange Rate
USDINR=X - US Dollar Indian Rupee Exchange Rate
EURCAD=X - Euro Canadian Dollar Exchange Rate
AUDCAD=X - Australian Dollar Canadian Dollar Exchange Rate
NZDCAD=X - New Zealand Dollar Canadian Dollar Exchange Rate
EURSEK=X - Euro Swedish Krona Exchange Rate
EURNZD=X - Euro New Zealand Dollar Exchange Rate
GBPNZD=X - British Pound New Zealand Dollar Exchange Rate
CADJPY=X - Canadian Dollar Japanese Yen Exchange Rate
CHFJPY=X - Swiss Franc Japanese Yen Exchange Rate
EURMXN=X - Euro Mexican Peso Exchange Rate
GBPCAD=X - British Pound Canadian Dollar Exchange Rate
AUDNZD=X - Australian Dollar New Zealand Dollar Exchange Rate
USDPLN=X - US Dollar Polish Zloty Exchange Rate
USDSGD=X - US Dollar Singapore Dollar Exchange Rate
USDKRW=X - US Dollar South Korean Won Exchange Rate
USDHKD=X - US Dollar Hong Kong Dollar Exchange Rate
USDTRY=X - US Dollar Turkish Lira Exchange Rate
EURTRY=X - Euro Turkish Lira Exchange Rate
GBPTRY=X - British Pound Turkish Lira Exchange Rate
AUDCHF=X - Australian Dollar Swiss Franc Exchange Rate
CADCHF=X - Canadian Dollar Swiss Franc Exchange Rate
NZDCHF=X - New Zealand Dollar Swiss Franc Exchange Rate
EURPLN=X - Euro Polish Zloty Exchange Rate
USDHUF=X - US Dollar Hungarian Forint Exchange Rate
EURHUF=X - Euro Hungarian Forint Exchange Rate
USDTHB=X - US Dollar Thai Baht Exchange Rate
USDIDR=X - US Dollar Indonesian Rupiah Exchange Rate
USDPHP=X - US Dollar Philippine Peso Exchange Rate
EURSGD=X - Euro Singapore Dollar Exchange Rate
GBPSGD=X - British Pound Singapore Dollar Exchange Rate
AUDUSD=X - Australian Dollar US Dollar (lặp chính)
USDBRL=X - US Dollar Brazilian Real Exchange Rate
EURBRL=X - Euro Brazilian Real Exchange Rate
USDCLP=X - US Dollar Chilean Peso Exchange Rate
USDARS=X - US Dollar Argentine Peso Exchange Rate
USDRUB=X - US Dollar Russian Ruble Exchange Rate
EURRUB=X - Euro Russian Ruble Exchange Rate
USDILS=X - US Dollar Israeli Shekel Exchange Rate
EURILS=X - Euro Israeli Shekel Exchange Rate
USDVND=X - US Dollar Vietnamese Dong Exchange Rate
EURVND=X - Euro Vietnamese Dong Exchange Rate
USDMYR=X - US Dollar Malaysian Ringgit Exchange Rate
EURMYR=X - Euro Malaysian Ringgit Exchange Rate
USDNAD=X - US Dollar Namibian Dollar Exchange Rate
USDKEA=X - US Dollar Kenyan Shilling Exchange Rate
USDTWD=X - US Dollar New Taiwan Dollar Exchange Rate
EURTWD=X - Euro New Taiwan Dollar Exchange Rate
GBPTWD=X - British Pound New Taiwan Dollar Exchange Rate
USDZMW=X - US Dollar Zambian Kwacha Exchange Rate
USDGHS=X - US Dollar Ghanaian Cedi Exchange Rate
USDNGN=X - US Dollar Nigerian Naira Exchange Rate
DX-Y.NYB - US Dollar Index
JPY=X - Japanese Yen
CHF=X - Swiss Franc
CAD=X - Canadian Dollar
AUD=X - Australian Dollar
NZD=X - New Zealand Dollar
SEK=X - Swedish Krona
NOK=X - Norwegian Krone
MXN=X - Mexican Peso
SGD=X - Singapore Dollar
HKD=X - Hong Kong Dollar
INR=X - Indian Rupee
KRW=X - South Korean Won
BRL=X - Brazilian Real
CNY=X - Chinese Yuan
RUB=X - Russian Ruble
ZAR=X - South African Rand
TRY=X - Turkish Lira
ILS=X - Israeli Shekel
PLN=X - Polish Zloty
HUF=X - Hungarian Forint